WWWWWWWWWWWWWWW
WW  WWW WW    W
WW    W    WW W
WWWW WWWWW WW B
W    W   W W WW
W WWWW W W    W
W    W W W WW W
W W  W W W  W W
W  W W W WW WWW
WW W   W  W WWW
WW W W WW    WW
 WWW W   WWW WW
M    W W   W  W
WWW WW WWW W  W
WWWWWWWWWWWWWWW
