WWWWWWWWWWWWWWW
W  WWWW WW    W
WW    W    WW W
WWWWW WWWW WW B
W        W W WW
W W WWWW W    W
W W WW W W WW W
W W  W W W  W W
W  W W W WW WWW
WW W   W  W WWW
WW W W WW    WW
 WWW W   WWW WW
M    W W   W  W
WWW WW  WW WW W
WWWWWWWWWWWWWWW
